10,3,3,3,3,3,3,3,11
6,1,1,1,d6n,1,1,1,5
6,30,37,32,37,30,37,30,5
6,31,30,30,30,30,32,32,5
6,30,37,32,37,30,37,30,5
6,31,30,30,30,30,30,30,5
6,30,37,30,30,30,32,30,5
6,30,30,32,d1d,32,30,30,5
12,4,4,4,4,4,4,4,13
