34,7,3,3,3,3,3,3,3,3,3,3,11,34,34,10,3,3,3,3,3,11
34,9,1,1,1,1,1,1,1,1,1,1,5,34,34,6,1,1,1,d1n,1,5
34,33,30,30,30,30,30,30,30,30,30,30,15,3,3,14,30,30,30,30,30,5
34,33,38,30,38,30,38,30,38,30,38,30,0,1,1,2,30,30,30,30,32,5
34,33,30,30,30,30,30,30,30,30,30,30,30,30,37,30,30,30,32,30,32,5
34,33,38,30,38,30,38,30,38,30,38,30,16,4,4,17,30,30,30,30,32,5
34,33,30,d0d,30,30,30,30,30,30,30,30,5,34,34,6,30,30,30,30,30,5
34,8,4,4,4,4,4,4,4,4,4,4,13,34,34,12,4,4,4,4,4,13
