7,3,3,3,3,3,3,3,3,3,3,3,3,11,34,10,3,3,3,3,3,11
9,1,1,1,1,1,1,1,1,1,1,1,1,5,34,6,1,1,1,d1n,1,5
33,30,30,30,30,30,30,30,30,30,30,30,30,15,3,14,30,30,30,30,30,5
33,30,30,30,30,30,30,30,30,30,30,30,30,0,1,2,30,30,30,30,30,5
33,30,30,30,30,30,30,30,30,30,30,30,30,30,37,30,30,30,32,30,30,5
33,30,30,30,30,30,30,30,30,30,30,30,30,16,4,17,30,30,30,30,30,5
33,30,30,d0d,30,30,30,30,30,30,30,30,30,5, ,6,30,30,30,30,30,5
8,4,4,4,4,4,4,4,4,4,4,4,4,13, ,12,4,4,4,4,4,13
