1111111111111111111111111111111
1990000000000000000000000000001
1910101010101010101010101010101
1000000000000000000000000000001
1010101010101010101010101010101
1000000000000000000000000000001
1010101010101010101010101010101
1000000000000000000000000000001
1010101010101010101010101010101
1000000000000000000000000000001
1010101010101010101010101010101
1000000000000000000000000000001
1010101010101010101010101010101
1000000000000000000000000000001
1111111111111111111111111111111