111111111111111111111111111111
199000000000000000000000000001
190001100000000000000001100001
100001100000000000000001100001
100000000000000000000000000001
100000000000000000000000000001
100000000000000000000000000001
100000000000000000000000000001
100000000000000000000000000001
100000000000000000000000000001
100001100000000000000001100001
100001100000000000000001100001
100000000000000000000000000001
111111111111111111111111111111